####S #############
#          #      #
####  ##  ###  ####
#          #      #
#########  #  ##  #
#     #    #   #  #
#  #####  ###  #  #
#          #   #  #
#E ################
