#S#E#
# ###
# # #
#   #
#####
