########
S     #E
# ### ##
# ### ##
#     ##
########
