####S #############
#     <    >      #
####  ##  ###  ####
#     >  ^ #      #
#########  #^^##  #
#     #    #   #  #
#  #####  ###  #  #
#              <  #
#E ################
