##S ############################################################
##  ########  ##########            #####  ########            #
##            ######      ########  ####   ################  ###
######  ####  ######  ##  ####  ##  #####           ##       ###
######  ####          ##  ####  ##  ##     #######  ##  ###  ###
##  ##  ################  ####  ##  ##  ########    ##  ###  ###
##  ##  ################### ##  ##  ##  ########  ####  ###    #
##  ##                   #####      ##        ##        ###  ###
##  ##  ###############  #############  ####  #############  ###
##      ######  #######                 ####      #########  ###
######  ##      ###########################################  ###
######  ######                                               ###
######  ######  #####  ##########  ###  ##########  ############
##      ######  #####     #        ###  ###  #####  ######     #
##  ##########  #####  ###############  ###  #####      ##  #  #
##  ######   #  #####  #######          ###  #########      #  #
##  ########    #  ##  #######  ###########  ################  #
##  #############  ##  #######  ###########          ########  #
##  ###            ##      ###          #########  ####  ####  #
########################   ########  ############        ####  #
#######                   #########  ############  ####        #
###############E ###############################################
